1111111111111
100000P000001
10C0111110001
1001000000001
100100E010001
1000111100111
1001100000001
1111111111111