1111111111
100W00P011
1E1111C001
1111CC0001
1111111111