1111111111111111111111
1001111C000100P0111111
1001C111100000C1111111
10000C0000010000010001
1C11100000001000000001
111100000000C1001100E1
110000C00000C100000001
1111100000000011111001
111110000000C000111111
10000C0000010000010001
1111111111111111111111